111111111
110010001
101110101
1010C0101
101111101
101C00C01
101011101
1000000E1
111110111