1111111111111111111111111111111111111111
1P000000000000000C0000000000000000000001
1011101110111011111011101110111011101111
1C000000C000000000000C000000C000000000C1
1011111011111011101111111011101110111011
1C000000C000000000000C000000C00000000C01
1110111011101110111011101110111011101111
1C000000000C000000C000000000C000000000E1
1111111111111111111111111111111111111111