11111111111111111111111111111111111111111111
1P0000000000C0000000E1100000000000C000000001
10111111111011111111011011111111101111111101
1010000C000010000C01011010000C000010000C0101
10101110111010111010111010111011101011101011
10101010101010101010111010101010101010101011
1C100000000000000001111C10000000000000000111
11101111111011111110111110111111101111111011
10000000000000000000000000000000000000000001
10111111111111111111111111111111111111111101
10001000001000000010111000100000100000001011
10111011101011111010111011101110101111101011
10100010001010001010111010001000101000101011
10101110111010101110111010111011101010111011
10101000100010101000111010100010001010100011
10101011111110101011111010101111111010101111
10101000000000101000011000000C0000000000C001
10101111111011101111011010100000000010100001
10101111111011101111011010100000000010100001
1000000C0000000000C0011000000C0000000000C001
11111111111111111111111111111111111111111111