111111111111111111111111111111111111111111111111111111
1P000000C000000C000000C000000C000000C000000C0000000001
101111101110111011101110111011101110111011101110111011
1C000000C000000C000000C000000C000000C000000C00000000C1
111011111011111011101110111011101110111011111011111011
1C000000000000000C000C000C000C000C000000000000000000E1
111011101110111011111011111011101111101110111011101111
1C000000C000C000000000000000000000000C000000C000C00001
111011101110111011101111111011101110111011111011111011
1C000000C000000C000000C000C000000C000C000000C0000000C1
101111101110111011101111101110111011101110111011101111
1C000C000000000C000000000C000000000000C000C000000C0001
111011111011111011101110111011101111101110111011111011
1E000000000000000C000000000000000000C00000000000000001
111111111111111111111111111111111111111111111111111111