1111111111111111111111111
10000P0011111111111110001
100E0CCCCCCCCCCCCCCCC0001
10101010111111111010C0101
1010CCCCCCCCCCCCCCCCC0001
1011C11111111111111111011
1010C11111CCCCC1111100001
1010CCCCCCC001C0000000001
1010111111C011C0000000001
1CCCCCCCCCCCC0C0000000001
1111111111111111111111111
