1111111111111111111111111111111111111111
1P000C000000000C000C000C000000C000000001
1011101110111110111011101110111011101111
1C000000C000000C000000000000C000000000C1
1011111011101110111011111011101110111011
1C000C000C000000000000C000000000C00000C1
1110111011111011111011101110111011101111
1C000000000000000C000000C000000000C00001
1110111110111110111011101110111011111011
1C000C000C000C000000000C000000C0000000C1
1011111011101110111110111011101110111011
1E000000000000000C000000C000000000000001
1111111111111111111111111111111111111111