111111111111111
1000C0000000C01
101111011110101
101C010C010C101
101011111110101
1010000P0000101
111011111110111
10001C0000C0001
101111011110111
1010C010C010C01
101011111110101
1000000000000E1
111101111011111
100000000000001
111111111111111