1111111111111111111111111111111111111111
1P000C000000C000C000000000C0000000000001
1011111011101110111011101110111011101111
1C000000000000000000000000000000000000C1
1110111011101110111011101110111011101111
1C000C000C000000C000000C000000C00000C001
1011111110111110111011111011111011111011
1C000000000000000000000C00000000000000E1
1111111111111111111111111111111111111111